11111111111111
1C000000C00001
1000001000C001
1P0001E1000001
1000C0000C0001
10C0000C0000C1
11111111111111
