111111111
1E000C001
100000001
1000CPC01
111111111
