1111111111111
10010000001C1
1100011111111
1P01100001E01
1111111111111