1111111111111111111111111111111
1P0C0000000000000000000000000E1
10111101011110000000C1111111101
101000010C001001111100000000001
101011C101101011C1011C101111101
101011010110101101C110101000001
1010110101101011010110101011111
10101101C1101011010110101010C01
1C1011010110000001011010101C101
1010110101111111110110101010101
111111111111111111111111111C101
1C000C000C0000000000000000000C1
1111111111111111111111111111111