11111111
100C0001
100E0001
100P0001
11111111