11111111111111111111111111
10000C010CCE0000000C11C001
1P001C000000100000C0CCC001
11111111111111111111111111