11111111111111111111111111111
100000000000000C00000C0000001
1010010100100E001010010010101
10100100101010100010010010101
1P0000000C00C00000000000000C1
11111111111111111111111111111