111111111111111111111111111111
10P011100000000000000000000001
1000000000000000000C000C000001
10011100000000000001100C000001
10000000000000E00000000C000001
100000000000000000000000001101
1000C00C0000000000011111111101
111111111111111111111111111111