11111111111111111
1C00C001C100000C1
10000000000000001
1000000001000E001
1C0000000C00000C1
10000001P10000001
10000000000000011
11111111111111111